

1111111111
1000E00101
1000000001
1000101001
101010P101
10000C0001
1111111111



